10
|=========|
|#####====|
|#@  #====|
|# OO#=###|
|# O #=#X#|
|### ###X#|
|=##    X#|
|=#   #  #|
|=#   ####|
|=#####===|
||========|
