8
|==========|
|=#######==|
|=#     ###|
|##O###   #|
|# @ O  O #|
|# XX# O ##|
|##XX#   #=|
|=########=|
||=========|
